333333333333333333
300033000000330003
300000000000000003
300000000000000003
300000000000000003
333300000000003333
333300000000003333
300000000000000003
300000000000000003
300000000000000003
300033000000330003
333333333333333333