3333333333333333
3000000000000003
3000000000000003
3003300000033003
3003300000033003
3000000000000003
3000000000000003
3000330000330003
3000330000330003
3000000000000003
3000000000000003
3333333333333333