000000000
000111100
000100100
000101100
000111000
000000000