00000000000000
03333333333000
03221100113000
03221100119000
03111100009000
03111100223000
03000000223000
03333333333000
00000000000000