3333333333333333
3000000000000003
3000000000000003
3000000000000003
3000000000000003
3000000000000003
3000300000000003
3000300000000003
3000300000000003
3000300000000003
3000000000000003
3333333333333333