00000000000000
08888888888000
08221100118000
08221100118000
08111100008000
08111100228000
08000000228000
08888888888000
00000000000000