6666666666666666660
6000000000000000060
6000000000000000060
6000000000000000060
6000222200033000060
6000222200033000060
6000222200022000060
6000222200022000060
6000000000011000060
6000000000011000060
6000000000000000060
6000000000000000060
6000000000000000060
6666666666666666660