8888888888888888880
8000000000000000080
8000000000000000080
8000000000000000080
8000222200033000080
8000222200033000080
8000222200022000080
8000222200022000080
8000000000011000080
8000000000011000080
8000000000000000080
8000000000000000080
8000000000000000080
8888888888888888880