3333333333333333330
3000000000000000030
3000000000000000030
3000000000000000030
3000222200033000030
3000222200033000030
3000222200022000030
3000222200022000030
3000000000011000030
3000000000011000030
3000000000000000030
3000000000000000030
3000000000000000030
3333333333333333330