3333333333333333333
3000000000000000003
3000000000000000003
3000000000000000003
3000330033003300003
3000330033003300003
3000000000002200003
3000000000002200003
3003300330001100003
3003300330001100003
3000000000000000003
3000000000000000003
3000000000000000003
3333333333333333333