333333333333333333
300000000000000003
300000000000000003
300000000000000003
300022220003300003
300022220003300003
300022220002200003
300022220002200003
300000000001100003
300000000001100003
300000000000000003
300000000000000003
300000000000000003
333333333333333333