3333333333333333
3000000000000003
3000000000000003
3003300330033003
3003300330033003
3000000000022003
3000000000022003
3003300330011003
3003300330011003
3000000000000003
3000000000000003
3333333333333333