00011100
00010100
00010100
00011100
00011100
00011000